NO mandatory/textures/north.xpm
SO mandatory/textures/south.xpm
WE mandatory/textures/west.xpm
EA mandatory/textures/east.xpm

F 220,100,0
C 225,30,1

111111111111111111111111111
100000000000000000000000001
1000N0000000000000000000001
100000100110000010001100001
100001100110000000011000001
10001111111110000110000001
10000000011000110011000000001
100000000010000111111000001
100000000000000000000000001
111111111111111111111111111
