NO                  mandatory/textures/TEST_IMG/Wolfenstein/bluestone.png
SO mandatory/textures/TEST_IMG/Wolfenstein/greystone.png
WE mandatory/textures/TEST_IMG/Wolfenstein/wood.png
EA mandatory/textures/TEST_IMG/Wolfenstein/redbrick.png






F      220,100,0
C      225,30,1






111111111111111111111111111
100000000000000000000000001
1000N0001110000001111100001    101
100000110110000010001100001     1
100001100110000000011000001
100011111111100000110000001
1               00000000110000011000000001
100000000110000111111000001     
1000000000000000000             00000001
111111111111111111111111111
