NO  mandatory/textures/north.xpm
SO mandatory/textures/south.xpm
WE mandatory/textures/west.xpm
EA mandatorytextures/east.xpm

F 25,100,00
C 225,30,10

111111111111111111111111111
10000N000000000000000000001
100000000000000000000000011
100000100110000010001100001
100001100110000000011000001
100011111111100001100000001
1000000011000110011100000011
10000000001000011111111000001
100000000000000000000000001
111111111111111111111111111
