NO  mandatory/textures/north.xpm
SO mandatory/textures/south.xpm
WE mandatory/textures/west.xpm
EA mandatory/textures/east.xpm

F 25,100,00
C 225,30,10


111111111111111111111111111
100000000000000000000000001
10000100000000000N000000011
100010100110000010001100001
100001100110000000011000001
100011111111100001100000001
100000001100011001110000001
100000000010000111111110001
100000000000000000000000001
111111111111111111111111111
